# created with: tools/importRebase link_parsrefs.txt restrSites2.txt
# time: 2016-10-15T01:10:53.174375
RGGWCCY	PpuMI	I,B
GTAC	RsaI	I,K,B,N
ACNGT	Tsp4CI	I,V,B,N
GCGATCGC	SgfI	I,B,N
RCATGY	NspI	I,B,V
ACATGT	BspLU11I	I,B,N
TCCGGA	BspMII	C,B,I,K,J,M,O,N,R,V
CGCCGGCG	Sse232I	B
AGTACT	ScaI	I,V
CATATG	NdeI	I,V
GGTACC	KpnI	I,N,B,M,V
TTCGAA	AsuII	B,V,I,K,J,M,N
TACGTA	SnaBI	I,B,V
CCTNNNNNAGG	EcoNI	I,B,V
GGTNACC	BstEII	I,K,B,V
CTTGAG	Bce83I	N
CTGCAG	PstI	X
GCTCTTC	SapI	I,B,N
CCGG	HpaII	C,B,I,K,J,N,Q,S,R,V,Y,X
GKGCMC	BseSI	I,N
CYCGRG	AvaI	Q,B,V,I,X,K,N
GTATCC	BciVI	I,B
CASTGNN	TspRI	B
CCGCGG	SacII	C,B,V,I,M,S
ATTTAAAT	SwaI	I,K,B,V
GTMKAC	AccI	I,B,V
CTCGAG	XhoI	I,Y,C,N,V
GAGTC	PleI	I,B,N
CCNGG	ScrFI	I,V,B,N
CGGCCG	XmaIII	R,S,B,V,I,K,N
CTGGAG	GsuI	I,N
GCNGC	Fnu4HI/BisI	I,B
ACGGC	BcefI	N
ACTGG	BsrI	I,B,V
GGTCTC	Eco31I	I,X,N,V
GACNNNGTC	Tth111I	B,N
CTYRAG	SmlI	B
GTSAC	Tsp45I	I,B
CTAG	MaeI	I,K,B,N
ACTAGT	SpeI	I,B,V
ACGT	MaeII	I,B,N
TCGCGA	NruI	B,V
CTTAAG	AflII	I,C,B,M,V
GAANNNNTTC	XmnI	I,B,M,V
CCTAGG	AvrII	S,B,V,I,K,M
GGCGCGCC	AscI	I,B
ATTAAT	VspI	K,J,N
GGCC	HaeIII	I,X,C,B,V
CAATTG	MfeI	K,B,M
ACTGGG	BfiI	I,N
AGCGCT	Eco47III	I,K,N
CCWWGG	StyI	I,K,B,V
RAATTY	ApoI	I,B,V
GCTAGC	NheI	I,V,B,N
RGATCY	XhoII	I,K,B,V,N
CGRYCG	McrI	I,N,B,V
TCATGA	BspHI	I,B
ACCTGC	BspMI	I,B,N
CTGAAG	Eco57I	I,N
GATC	DpnI/MboI	C,B,I,K,J,M,N,S,R,V
WCCGGW	BetI	N
GTGCAC	ApaLI	I,B,J,V
GRCGYC	AcyI	R,B,V,I,K,N
CACGAG	BsiI	I,B,N
CCGC	AciI	I,B
GGNCC	AsuI	C,B,V,I,K,J,N
ACCWGGT	SexAI	I,B
ACCGGT	AgeI	Q,C,B,V,I,X
GGNNCC	NlaIV	I,B,V
GACNNNNGTC	PshAI	I,B,V
GGCGCC	NarI	I,V,B,N
CCANNNNNTGG	PflMI	I,K,B,V
GTATAC	SnaI	I,K,B,V,N
GTTAAC	HpaI	B
GCNNNNNNNGC	MwoI	I,B
GACGC	HgaI	B
GACNNNNNGTC	Eam1105I	I,N,V
CTCAG	BseMII	N
GAAGAC	BbvII	I,N,B,V
CGTCTC	Esp3I	N
GTYRAC	HindII	B,K,J,O,N,Q,R,X
CCTNAGG	SauI	B,V,I,K,J,N
CTCTTC	Ksp632I	I,V,B,N
CMGCKG	NspBII	I,N,R,V
CTRYAG	SfeI	I,B,N
GRGCYC	HgiJII	B,V,I,X,K,J,N
GCATC	SfaNI	B
CCNNNNNNNGG	BsiYI	I,V,B,N
CCWGG	EcoRII	C,B,I,K,M,N,S,V
CTNAG	DdeI	I,B,V
CACNNNNGTG	OliI	N
CCSGG	CauII	R,B,V,I,K,J,N
YGGCCR	CfrI	I,K,N
CCCGGG	SmaI	I,N,B,R,V
ATCGAT	ClaI	C,B,V,I,X,N
TGATCA	BclI	I,K,V
GACGTC	AatII	I,N,V
GCAGC	BbvI	I,B
TTTAAA	AhaIII	B,I,K,J,M,N,Q,S,R,V,X
GCNNGC	Cac8I	I
CCNNGG	SecI	I,B,N
AACGTT	AclI	K,B
GTTTAAAC	PmeI	B
CCCAGC	BseYI	I,B
CGGWCCG	RsrII	I,K,R,B,V
GATATC	EcoRV	B
CCATGG	NcoI	I,V
CACNNNGTG	DraIII	B
CCTTC	Hin4II	N
CCGCTC	BsrBI	I,B,V
RCCGGY	Cfr10I	I,C,V,N
AATT	TspEI	I,N,B,V
GGTGA	HphI	I,V
TGTACA	Bsp1407I	I,N,V
GTNNAC	MjaIV	B,N
GCGCGC	BsePI	B,K,J,M,N,Q,R,X
RGCGCY	HaeII	I,B,V
GGGAC	FinI	I,B,N
GCATGC	SphI	B
YACGTR	BsaAI	I,B,V
GDGCHC	SduI	I,N,K,J,V
TTAA	MseI	I,B,R,M,V
GCTNAGC	EspI	I,N,K,B,V
GWGCWC	HgiAI	I,V,B,N
TCNNGA	Hpy178III	N
GAGCTC	SacI	C,B,V,I,R,N
CGTACG	SplI	I,B,N
GGGWCCC	SanDI	B
GAATGC	BsmI	I,B,V
CCRYGG	DsaI	I,V,N
GGATG	FokI	I,V,B,N
GGATC	BinI	I,B,N
TGCGCA	MstI	B,V,I,K,J,N
GCGGCCGC	NotI	I,V
GATNNNNATC	BsaBI	I,B,V
GCCGGC	NaeI	I,V,B,N
TGGCCA	BalI	B,V,I,M,O,N
CAYNNNNRTG	MslI	I,B,V
GACNNNNNNGTC	DrdI	I,B,V
GCWGC	TseI	N
GCANNNNNTGC	ApaBI	I,N
ATGCAT	AvaIII	B,I,K,J,M,N,Q,S,R,V,X
GAWTC	TfiI	B
AGCT	AluI	I
CGATCG	PvuI	I
CACGTG	PmaCI	Q,B,V,I,X,M,N
CACGTC	BtrI	B,N
GCGC	HhaI	S,B,V,I,R,M,N
CAGNNNCTG	AlwNI	I,B
TGCA	CviRI	N
GGGCCC	ApaI	I,N,B,V
GGYRCC	HgiCI	R,B,V,I,K,N
GGCCGGCC	FseI	I
GCAATG	BsrDI	I,B,V
GGWCC	AvaII	I,X,K,B,V
CATG	NlaIII	I,B,R,N
RGGNCCY	DraII	B,J,K,N
CCTGCAGG	Sse8387I	I,N,B,V
TTATAA	PsiI	B
CGCG	FnuDII	B,V,I,K,J,M,N
GTCTC	BsmAI	I,N,B,V
AGGCCT	StuI	I,C,B,V
